8000000000
8000000000
8000000000
c000000000
c000000000
c000000000
8000000000
0000000000
0000000000
0000000000
0000000000
0008000000
0008000000
0000000000
0000000000
