80007ff03e
8000ffe03e
8001ffe01e
c003ffe01e
c007ffe01c
c00fffe01c
807fffe01c
007f9ff038
007c1ff038
00f80ffef8
00f80ffff8
007007fff0
007007fff0
007003ffe0
0020019fc0
