00000000000000000000
00001000000000000001
00000000000000000001
00000000000000000001
00000000000000000003
00000000000000000003
00000000000000000000
00000000000000000000
00000000000000000000
00003000000000000380
00003000000800000001
00007000000c00080003
00007000000800380007
0000e00000000038000f
0001e000000000380007
0000e000000000100000
00000000000000000000
00000000000000000000
00000000000000000000
00000000000000000000
00000000000e00000000
00000000000e00000000
00000000000600000000
00000000000000000000
00008000000000000000
00008000000000000000
00018000000000000000
00018000000000003800
00038000002000003800
00078000007c00003800
