0007f0ffe00001fe000f
0007f0ffe00001ff000f
0007f1fff00001ff000f
0007fffff00001ff000f
0007fffff00003ff800f
0007ffc3f00003ffc00f
0007ffc0f00003ffe007
0007ff80f00007ffe00f
0007f380780007f8f00f
000fe18078000ff87c1f
000fe1803c000ff87f3f
000fe1803c100ff83fff
000fe0800ffc1ff03fff
000fe0c007ff3ff01fff
000fe0c007fffff01fff
000fe0e007fffff01fbf
001fe0e007ffffe00f1f
001fe0c007ffffe00f1f
001fe08007ffffe00f1f
001fe08007fc7fe00e18
000fe08007fc3fe00418
000fc08007fc0ff00018
000fc0c003fc07f00038
000fc06003fc07f80030
000fc07003fc03bc0070
000f807803fc013c0060
000f803c03fc003c0060
000f803c03fc003c0070
000f803c03fc003c007c
000f003e03fc003c0ffc
