0003c001ffc0000000000
0007c000ff80000000000
0001e000ff80000000000
0000f000ff00000000000
0000f8007e00000000000
00013c003000000000000
00001e003800000300000
00001f003800000700000
0001ff001800000700000
0001ff800000000700000
0001ff800000030f80000
0000fe00000007cf80000
0000ff020000078700000
0000ff1f80000f8700000
00003f3f80000f0380000
00003fff0000060000000
00003ffe0000060004000
000013ce00200c03ce000
000007c000781c03ce000
00000f8000381803fe000
0000000000301803fc000
0000000000003801f0000
000000000000f000e0000
000680000000c00000000
0007c0000000000000000
000f80000000000000000
000ff8000000000000000
000f00000000000000000
000f00000000000000000
000f80000000000000000
000780000000000000000
000380000000000000000
000000000000000000000
000000000000000800000
000000000000000800000
000000000000017800000
00000e00000003f800000
0000070000000ff000000
00000f0000001fe000000
4030078000041fe000000
c0380e0000060fc000000
c0381e0000060f8000000
903c1e000006020000000
f83800000000000000000
f00000000000000000000
fc0000000000000000000
000000000000000000000

