4000000000
4000100200
0000383e00
0000007c00
0000001c00
0060001800
0010000000
0002040000
0067e40000
00ffe00000
01f8000004
05f0000004
07f000000c
07e000001c
07f000001c
