00000007c0
00000007e0
0040030fe0
00e003bff0
00fc03fff8
01fe03fffc
00fe07f87c
00fc07e03c
007e07e00c
003fdfe006
003fffc006
003fffc00f
001fff000f
000000001f
000000001f
