c203800fe0
4207c03fe4
021fffffe8
003fffffc8
007fffff98
007ffff3a0
007ffc0180
00df3a00c0
000f020040
000f360861
0007820077
000780003f
000780003f
000380001f
000380005f
