c200c00000
4200c00000
0200000000
0000000000
0000000000
0001000040
0003800040
0003000000
0003800020
0000000800
0000000004
0000000000
0000000000
0000000000
0000000000
