07e000003c
07f000001c
07f000001c
07f0000004
01f0000004
00ffc00000
007fe40000
0002040000
0000000000
0020001800
0000001c00
0000007c00
0000187e00
0000300e00
4000100600
