0000000f00
0000000f00
0000000f00
0000000f00
0000007e00
0000007e00
0000007e00
0000007e00
0000001800
0000000000
0000000000
0000000000
0000000000
0000060000
0000060000
