0c0000f800
0c2001f800
0e6001fc00
0ff003fc00
07f003fe00
03f803ff00
01f83fff00
01fc7fff90
01ffff81f8
00ffff01f8
00fffe00f8
007fe00078
0039c0003c
007180003c
007080003e
