0000000000
0000000000
0000003000
0000003e00
000000ff00
000000f800
000000f000
000001f000
000003f000
000001f800
0000000000
0000000000
0000000000
0000000000
0010000000
