800010100000
800000100000
80e000060000
00f0400f0000
01f0000f8000
01f0000f8000
01f0001f8000
01f0001f8000
01f0001f8000
03f0001f8000
07f8003fc000
2ffc007fe000
1ffe00fff100
bfff01fff860
7f1f83f9fc60
7e1fc3f0fef0
fc6fcfe07ff0
f807ffc07ff0
f007ff803ff8
f003ff001ff8
e000ff000ffc
e0007e0007fc
c0007e0007fe
c0007e000ffe
c0007e000fff
c0007e001fff
c0003c000fff
83003c00cfff
8000181007ff
04c0d80007ff
