00008000fc
0000800078
0000000030
0000000000
0000000000
0000000000
0000000000
0000000200
0000000300
0000001e00
0000001c00
0004001000
000c002000
000c000000
000c008000
